17x17
11111111111111111
13000010000000001
13111110111111101
13100000133310001
13101111131310111
13101010031310121
13101010131311131
13001000131333331
13111011131110101
13331000131000101
11131110131111111
13331000133333331
13111111111110131
13333313333310131
11111313111311131
10000333100333331
11111111111111111
http://news.povray.org/povray.binaries.images/attachment/%3Cweb.4f36a9c2be81e7d194d713cc0@news.povray.org%3E/maze_test_samples.jpg