18x18
111111111111111111
133333333333333331
101011111111111131
101000000100333131
101111010101313131
101001010101313131
101000010101313331
101011111111311111
101000000001333331
101110101001111131
101000100100010131
101011101110133331
101010101010131111
101010101010133331
101000100000010131
101111111111111131
100000000000000121
111111111111111111
