33x33
111111111111111111111111111111111
133333000010033313331010133313331
111113111111131313131010131313131
133333001333331313131000131313131
131010101311111313131011131313131
131010101300001333131333331313131
131111111311111111131311111313131
133333331313331000031333331333131
111111131313131111131111131111131
101003331313131010131333331010131
101113111313131010131311111010131
133333001313131010133310000000131
131111101313131010111011101111131
133333101333133333100000100000131
111113111111111113111111111011131
133333133333133333000000101333131
131110131013131111111111101313131
133310131013330000100333333313131
101311131111101111101310101113131
101333133300101000101310100013131
111113111310111010111311111113131
100003333310000010100333330013331
111110111111111011111010131111111
100010000000000000101010133333331
101111111010101111101011111111131
100000101010101000001013333313331
111110101111111011101013101313111
101000100000101010100013101333001
101110101111101110111013101111111
101000100000000000000013101333001
101010101110111110111113111313111
100010000010001000000013333313321
111111111111111111111111111111111
http://jimblackler.net/blog/wp-content/uploads/2012/01/Screen-shot-2012-01-04-at-6.33.38-PM.png