17x17
11111111111111111
13330013333333331
10131113111111131
10133313100000121
10111313111110111
10133313333310001
10131011111311101
10131000101333331
10131110101111131
10133310000000131
10111311111011131
10101333331013331
10101111131113111
10101333331333101
10101311111311101
10001333333300001
11111111111111111
https://arcadekomodo.com/home/wp-content/uploads/2013/10/DFSMaze.png